111111111111111111111111111111111111111111
1E0000000000000C00000000000000000C00000001
1000000000000000000000000000000000000000C1
1P0000C00000C00000000000C00000000C000000C1
111111111111111111111111111111111111111111